XXXXXXXXXXXXXXX
X      P      X
X XXXXXXXX XX X
X X   X     X X
X X X X     X X
X X X X       X
X X X XXXXXXXXX
X X X X   X   X
X X X X T X X X
X X X X     X X
X X X XXXXXXX X
X X X X       X
X X X XXXXX X X
X   X       X X
XX XXXXXXX  XXX
X             X
XXXXXXXXXXXXXXX