XXXXXXXXXXXXXXXX
X     X        X
X  X  XXXX XXX X
X  X     X   X X
X XXXXX  X   X X
X X        X X X
X XXXXX XXXX   X
X     X X  XXXXX
X X X X XX     X
X X X X        X
X X X XXXX X   X
X X X  T X X   X
X X X    X X XXX
X X XX XXX X   X
X X  X X   XXX X
X XXXXXXX XX   X
X            X X
XXXXXXXXXXXXXXXX

