XXXXXXXXXXXXXX
X............X
XXX.XX.X..X..X
XX..XXXXX.XXXX
X..X....X....X
X.X..XX.XXXX.X
X...X...X....X
XXXXX.X.X.XXXX
X....XXXX.X.XX
XXX.X...X....X
X.X.X.X.X.XXXX
X.....X......X
XXXXXXXXXXXXXX