XXXXXXXXXXXXXXXXXXXX
XP..X..X...X.......X
X.X.X.X.X.X.X.XXXX.X
X.X.X.X.X.X.X.XXXX.X
XOX..@@@@@@@@@@....X
XOXXXXXXXXXXXXXXXX.X
XO..X..X.X.........X
XOX..XXX...XXX.XXX.X
XOXX.....X.....X...X
XOX.XXX.X.X.X..X.X.X
XOX....X...X.XXX..XX
XOXX.X.X...X.......X
XOX..X.XX..X.XXXXX.X
XOXX.X....X.@@@@@@.X
XOX.@XXX.X..XX..XX.X
XOXX@...X.....XX...X
XOX.@.X...X.X....X.X
XXXX@XXXXXX.XXXXXX.X
X...@OOOOOOOOOOOOOOX
XXXXXXXXXXXXXXXXXXXX