XXXXXXXXXXXX
X  X    XXXX
X  X XX X  X
XK   X  X XX
XXX  X     X
X    X  XXXX
X    P     X
XXXXXXX  XXX
X     X    X
X  XTTX  X X
X  XXXX  X X
X        XXX
XXXXXXXXXXXX